3,3,3,3,3,3,3,3,3,3,3,3,3,3,3,3,3,3,3,3,3,3,3,3,3,3,3,3,3,3,3,3,3,3,3,3,3,3,3,3,3,3,3,3,3,3,3,3,3,3,3,3,3,3,3,3,3,3,3,3,3,3,3,3,3,3,3,3,3,3,3,3,3,3,3,3,3,3,3,3,3,3,3,3,3,3,3,3,3,3,3,3,3,3,3,3
3,3,3,3,3,3,3,3,3,3,3,3,3,3,3,3,3,3,3,3,3,3,3,3,3,3,3,3,3,3,3,3,3,3,3,3,3,3,3,3,3,3,3,3,3,3,3,3,3,3,3,3,3,3,3,3,3,3,3,3,3,3,3,3,3,3,3,3,3,3,3,3,3,3,3,3,3,3,3,3,3,3,3,3,3,3,3,3,3,3,3,3,3,3,3,3
3,3,100,100,100,100,107,100,100,100,100,100,100,107,100,100,100,100,100,100,100,100,100,100,100,100,100,107,107,107,100,100,100,100,100,100,100,100,100,100,100,100,100,100,100,100,100,100,100,100,100,100,100,3,3,100,100,100,100,100,100,100,100,100,100,100,100,100,100,100,100,100,100,100,100,100,100,100,100,100,100,100,100,100,100,100,100,100,100,100,100,100,100,100,3,3
3,82,0,0,7,0,54,7,120,120,120,120,120,7,197,0,7,0,7,7,0,7,0,0,0,7,0,0,0,0,7,0,201,7,0,7,0,0,7,0,7,120,120,7,0,7,0,7,120,0,7,7,0,93,82,0,7,0,7,7,0,152,150,151,120,120,120,120,0,7,0,0,7,7,0,7,0,120,120,120,120,57,7,0,120,7,152,150,150,150,151,120,120,7,93,3
3,82,0,0,0,0,0,7,0,0,0,0,0,7,0,0,7,0,0,0,0,7,0,0,0,0,0,128,0,0,7,0,0,7,0,7,0,0,0,0,7,0,0,7,0,7,0,7,0,0,7,7,118,93,82,0,7,0,0,7,0,0,0,0,0,0,0,0,0,7,0,0,0,7,0,0,0,0,0,0,0,0,7,0,0,0,0,0,0,0,0,0,0,7,93,3
3,82,0,0,0,0,0,0,0,0,0,0,0,0,0,0,7,0,0,0,0,7,0,0,0,0,0,130,0,0,7,0,0,7,0,0,0,0,0,0,0,0,183,0,0,7,0,0,0,0,7,7,0,93,82,0,7,0,0,7,0,0,0,0,183,0,0,0,0,0,0,0,0,7,0,0,0,183,0,0,0,0,0,0,0,0,0,0,0,0,0,0,0,7,93,3
3,82,137,134,137,138,219,0,138,143,54,138,0,91,0,0,0,0,0,54,138,138,142,138,91,0,138,147,138,175,138,138,0,7,0,0,138,0,138,138,84,138,0,91,138,138,57,138,138,0,84,7,134,93,82,121,7,0,0,7,84,91,138,138,138,138,134,137,138,138,0,84,174,0,91,0,138,138,138,57,138,138,138,138,0,84,0,138,0,0,0,0,0,0,93,3
3,3,65,65,65,65,78,78,78,65,65,65,65,65,66,0,0,0,0,77,78,78,78,78,78,78,78,65,65,65,65,66,0,7,0,0,77,78,78,78,78,78,78,78,65,65,65,65,65,65,65,65,65,3,82,0,7,0,0,77,65,65,65,65,65,65,65,65,65,65,78,78,78,78,78,78,78,78,78,78,78,78,78,78,78,78,78,78,78,66,0,0,0,0,93,3
3,3,100,100,100,100,100,100,100,100,100,100,100,3,82,0,0,0,0,93,3,3,3,100,100,100,100,100,100,100,3,82,0,7,0,0,93,3,100,100,107,100,100,100,100,100,100,107,100,100,100,100,100,3,82,0,0,0,118,93,3,3,3,3,3,3,3,3,3,3,3,3,3,3,3,3,3,3,3,3,3,3,3,3,3,3,3,3,3,82,0,0,128,0,93,3
3,82,153,153,151,7,7,120,120,7,152,153,153,93,82,0,128,0,0,93,3,3,82,153,153,151,0,7,0,7,93,82,121,7,0,0,93,82,0,7,0,120,0,7,0,0,128,0,0,120,120,7,0,93,82,0,0,0,118,93,3,3,3,3,3,3,3,3,3,3,3,3,3,3,3,3,3,3,3,3,3,3,3,3,3,3,3,3,3,82,121,0,130,0,93,3
3,82,0,0,0,7,0,0,0,7,0,0,118,93,82,0,130,0,0,93,3,3,82,0,0,0,0,7,0,0,93,82,0,0,0,118,93,82,0,7,0,0,0,0,0,0,130,0,0,0,0,7,0,93,82,121,0,0,118,93,3,100,100,100,100,100,100,100,100,100,100,100,100,100,100,100,100,100,100,100,100,100,100,100,100,100,100,100,100,108,0,0,130,0,93,3
3,82,0,183,0,7,0,0,0,7,0,0,0,93,82,0,130,0,118,93,3,3,82,0,0,128,0,7,0,0,93,82,0,0,0,0,93,82,0,7,0,0,0,0,0,0,130,0,0,0,0,0,0,93,82,0,0,0,0,93,82,0,0,7,0,7,7,201,120,0,7,120,0,7,7,120,120,0,0,7,0,120,7,7,0,120,0,7,0,7,0,0,130,0,93,3
3,82,137,0,54,7,0,0,0,7,0,84,134,93,82,0,130,0,0,93,3,3,82,121,0,130,0,0,84,134,93,82,121,0,128,0,93,82,0,0,0,0,0,0,0,128,130,0,0,0,0,0,0,93,82,121,0,0,0,93,82,121,0,7,0,0,7,0,0,0,7,0,0,7,7,0,0,0,0,0,0,0,7,0,0,0,0,7,0,7,0,0,112,0,93,3
3,3,65,65,65,66,0,0,0,7,77,65,65,3,82,0,130,0,118,93,3,3,82,0,0,130,0,77,65,65,3,82,0,0,147,0,93,82,0,0,0,0,0,0,0,130,130,0,0,0,0,0,0,93,82,121,0,128,0,93,82,0,0,7,0,0,7,0,0,0,0,0,183,0,7,0,0,0,0,0,0,0,7,0,0,0,0,0,183,7,0,0,0,0,93,3
3,3,100,100,100,108,0,0,0,7,99,100,100,100,108,0,130,0,0,99,100,107,108,121,0,130,0,99,107,107,3,82,0,0,147,0,93,82,137,175,84,138,138,0,0,130,130,0,0,0,143,91,134,93,82,0,0,130,118,93,82,137,175,84,0,0,7,0,0,0,138,91,91,138,138,138,138,0,84,0,0,0,7,0,0,84,138,138,138,138,138,138,142,134,93,3
3,82,0,7,0,7,0,0,0,7,0,7,7,0,0,0,130,0,0,7,120,197,7,0,0,130,0,7,7,0,93,82,0,0,130,0,93,3,65,65,65,65,65,66,0,130,130,0,77,77,77,77,65,3,82,0,0,130,0,93,3,65,65,65,66,0,7,0,0,77,65,65,65,65,65,65,65,65,65,66,0,0,7,0,77,65,78,78,78,78,78,78,78,78,3,3
3,82,0,7,0,0,0,0,0,0,0,7,7,0,0,0,112,0,0,7,0,0,0,0,0,130,0,7,0,118,93,82,121,0,130,0,99,100,100,107,100,107,100,108,0,130,130,0,99,107,107,107,107,107,108,0,0,130,0,99,100,100,100,3,82,0,7,0,0,93,3,3,3,3,3,3,3,3,3,82,121,0,7,0,93,3,3,3,3,3,3,3,3,3,3,3
3,82,0,7,0,0,0,0,54,0,0,183,0,0,0,0,183,0,0,0,0,0,0,0,0,130,0,0,0,0,93,82,121,0,130,0,54,7,0,7,0,7,0,0,0,130,130,0,38,0,7,0,7,0,7,0,0,130,0,7,7,0,7,93,82,0,7,0,0,93,3,100,100,100,100,100,100,100,100,108,0,0,7,0,99,100,100,100,100,100,100,100,100,100,3,3
3,82,0,7,0,0,0,138,54,84,0,138,138,138,174,138,138,84,138,138,0,91,142,0,138,147,138,251,0,134,93,82,0,0,130,0,0,7,0,0,0,7,0,0,0,130,130,0,54,0,7,0,7,0,0,0,0,130,0,0,7,0,7,93,82,121,0,0,118,93,82,0,7,0,0,120,7,0,0,7,0,0,7,0,0,7,0,120,120,120,7,0,7,0,93,3
3,82,0,0,0,0,77,65,65,78,65,65,65,65,65,65,65,65,65,78,65,65,65,78,65,65,65,65,65,78,3,82,0,0,130,0,0,7,0,0,183,0,0,0,0,130,130,0,54,0,7,0,0,0,0,183,0,130,0,0,7,0,0,93,82,0,0,0,0,93,82,121,7,0,0,0,0,0,0,7,0,0,0,0,0,7,0,0,0,0,7,0,7,0,93,3
3,82,0,0,0,0,93,3,100,100,100,100,100,100,107,100,100,100,100,100,100,107,100,100,100,100,100,100,100,100,3,82,121,0,147,0,0,138,138,138,138,138,175,91,0,147,147,0,54,138,7,84,158,138,138,138,138,147,138,0,0,0,0,93,82,0,0,128,0,93,82,0,7,0,183,0,0,0,0,0,0,0,0,0,0,0,0,0,0,0,0,0,7,0,93,3
3,82,0,0,0,0,93,82,0,7,41,0,120,7,0,196,7,7,0,0,7,0,120,0,7,0,7,0,0,0,93,82,0,0,130,0,77,65,65,65,65,65,65,66,160,161,161,162,77,65,65,65,65,65,65,65,65,65,66,0,0,0,118,93,82,0,0,130,0,93,82,137,142,84,84,54,138,138,138,138,138,138,134,137,0,84,0,138,0,0,0,0,7,0,93,3
3,82,0,0,0,118,93,82,0,0,57,0,0,7,0,0,7,0,0,0,7,0,183,0,0,0,7,0,184,0,93,82,0,0,130,118,93,3,3,3,3,3,3,82,177,176,176,190,93,3,3,3,3,3,3,3,3,3,82,121,0,0,0,93,82,0,0,130,118,93,3,65,65,65,65,65,65,65,65,65,65,65,65,65,65,65,65,65,65,66,0,0,0,0,93,3
3,82,0,0,128,118,93,82,137,0,57,0,0,7,0,0,138,138,138,0,0,138,138,138,138,0,7,134,137,134,93,82,121,0,147,0,93,3,3,3,3,3,3,3,65,65,65,65,3,3,3,3,3,3,3,3,3,3,82,0,0,0,0,93,82,121,0,130,0,93,3,100,100,100,100,100,100,100,100,100,100,100,100,100,100,100,100,100,3,82,0,0,0,0,93,3
3,82,0,0,130,0,93,3,65,65,66,0,0,7,0,77,65,65,65,78,78,65,65,65,78,65,65,65,65,65,3,82,0,0,147,0,93,3,3,3,3,3,3,3,3,3,3,3,3,3,3,3,3,3,3,3,3,3,82,0,0,0,0,93,82,121,0,130,0,93,82,0,7,0,0,150,0,7,0,7,0,7,0,7,41,7,7,0,93,82,121,0,0,0,93,3
3,82,0,0,130,0,99,100,100,100,108,0,0,0,0,99,100,100,100,0,0,100,100,100,100,100,100,100,100,100,3,82,121,0,130,0,99,100,107,100,100,100,100,100,100,100,100,100,100,100,100,3,3,100,100,100,100,100,108,0,0,0,118,93,82,0,0,130,0,99,108,0,7,0,0,0,0,0,0,7,0,0,0,7,57,0,7,0,93,82,0,0,128,0,93,3
3,82,0,0,130,0,7,0,7,0,0,0,0,0,0,0,7,120,120,83,92,0,0,120,7,120,0,120,0,0,93,82,121,0,130,0,0,7,120,0,7,7,7,0,120,120,120,120,7,7,0,93,82,0,7,7,7,196,7,0,0,0,118,93,82,0,0,112,0,7,0,0,0,0,0,0,0,0,0,7,0,0,0,7,57,0,0,0,93,82,121,0,130,0,93,3
3,82,0,0,130,0,0,0,7,0,0,0,0,0,128,0,7,0,0,99,108,0,0,0,0,0,0,0,0,0,93,82,121,0,147,0,0,7,0,0,7,7,0,0,128,0,128,0,0,7,0,93,82,0,0,7,7,0,7,0,0,0,0,93,82,0,0,0,0,0,0,0,0,0,0,0,0,0,0,0,0,0,0,7,57,0,0,0,93,82,121,0,130,0,93,3
3,82,0,0,130,0,0,0,7,0,0,0,0,183,130,0,0,0,0,0,0,0,0,57,0,0,0,0,0,0,93,82,0,0,130,0,0,0,183,0,0,7,0,0,112,0,112,0,0,0,0,93,82,0,0,7,0,0,7,0,183,0,0,93,82,0,0,0,0,0,0,0,0,0,183,0,0,183,0,0,0,0,0,7,57,183,0,0,93,82,121,0,130,0,93,3
3,82,137,91,147,138,141,138,138,173,138,134,137,138,147,0,138,0,0,186,138,0,84,57,134,137,138,185,0,134,93,82,137,0,147,84,138,138,138,138,138,138,0,0,0,0,0,0,84,0,134,93,82,0,0,7,0,54,0,133,84,133,134,93,82,137,84,54,138,138,91,134,137,133,133,133,133,133,134,137,84,175,133,133,57,0,0,134,93,82,0,0,130,0,93,3
3,3,65,65,78,65,65,65,78,65,65,65,78,78,78,78,78,78,78,78,78,78,78,78,78,78,78,78,78,78,3,3,65,65,65,65,65,65,65,65,65,65,66,0,0,0,0,77,78,78,78,3,82,0,0,7,0,77,78,65,78,78,78,3,3,65,65,65,65,65,65,65,65,65,65,65,65,65,65,65,65,65,65,65,65,65,65,65,3,82,0,0,130,0,93,3
3,3,3,3,3,3,3,3,3,3,3,3,3,3,3,3,3,3,3,3,3,3,3,3,3,3,3,3,3,3,3,3,3,3,3,3,3,3,3,3,3,3,82,0,0,0,0,93,3,100,100,100,108,0,0,0,0,93,3,100,100,100,100,100,100,100,100,100,100,100,100,100,100,100,100,100,100,100,100,100,100,100,100,100,100,100,100,100,3,82,121,0,130,0,93,3
3,3,100,100,100,100,100,100,100,100,100,3,3,3,3,3,100,100,100,100,100,100,100,100,100,100,100,100,100,3,3,3,3,3,107,107,107,107,107,107,107,107,108,135,0,0,118,93,82,153,153,151,7,0,0,128,118,93,82,150,151,7,120,120,7,7,120,152,150,150,150,151,120,120,120,7,120,197,54,7,0,0,7,0,7,7,0,150,93,82,0,0,147,0,93,3
3,82,153,153,151,7,7,120,152,153,153,93,3,3,3,82,153,153,153,151,120,120,7,152,153,153,153,41,153,93,3,3,3,82,153,153,153,151,7,7,120,152,153,151,0,0,118,93,82,0,0,0,7,0,0,130,118,93,82,0,0,7,0,0,7,7,0,0,0,0,0,0,0,0,0,7,0,0,54,0,0,0,0,0,7,0,0,0,93,82,0,0,130,0,93,3
3,82,0,0,0,0,7,0,0,0,0,93,3,3,3,82,0,0,0,0,0,0,7,0,0,0,0,57,0,93,3,3,3,82,0,0,0,0,7,7,0,0,0,0,0,0,0,93,82,0,0,0,7,0,0,130,0,93,82,0,0,0,0,0,0,7,0,0,0,0,0,0,0,0,0,7,0,0,0,0,183,0,0,0,0,0,0,0,93,82,0,0,130,0,93,3
3,82,0,128,0,0,0,0,0,0,118,93,3,3,3,82,0,0,128,0,0,0,0,0,0,0,0,57,0,93,3,3,3,82,0,0,0,0,0,7,0,0,0,0,0,183,0,93,82,0,0,0,7,0,84,147,134,93,82,0,128,0,0,0,128,0,0,0,0,0,54,0,0,91,91,0,0,54,134,137,0,84,91,0,0,0,0,0,99,108,0,0,147,0,93,3
3,82,0,130,0,0,0,0,0,0,0,99,100,100,100,108,0,0,130,0,0,84,133,133,0,0,0,57,0,99,100,100,100,108,0,0,0,0,0,84,138,138,138,134,137,84,134,93,82,0,0,0,0,77,65,65,65,3,82,0,130,0,0,0,130,0,0,0,0,77,65,65,65,65,65,65,65,65,65,65,65,65,65,66,0,0,0,0,7,0,0,0,130,0,93,3
3,82,0,130,0,0,0,0,0,0,0,54,7,0,120,0,0,0,130,118,77,65,65,65,66,0,0,57,0,0,7,0,0,7,128,0,0,0,77,65,65,65,65,65,65,65,65,3,82,0,0,0,0,93,67,68,68,76,82,0,130,0,0,0,130,0,0,0,77,3,100,100,100,100,100,100,100,100,100,100,100,100,3,82,0,0,0,0,7,0,0,0,130,0,93,3
3,82,0,130,0,0,77,66,0,0,0,0,7,0,0,0,0,0,130,118,93,3,3,3,82,0,0,0,0,0,7,0,0,7,130,0,0,0,93,3,100,100,100,100,100,100,100,3,82,0,128,0,0,93,83,67,76,92,82,0,130,181,0,0,130,0,0,0,93,82,153,151,7,201,7,7,120,120,7,7,152,153,93,82,121,0,0,183,7,0,0,0,130,0,93,3
3,82,0,130,0,0,93,82,0,0,0,0,183,0,0,0,0,0,130,0,93,3,3,3,82,0,0,0,0,0,0,183,0,7,130,0,0,0,93,82,7,120,120,120,7,120,153,93,82,0,130,0,0,93,83,99,108,92,82,137,147,138,138,138,147,84,0,134,93,82,0,0,7,0,7,7,0,0,7,0,7,0,93,82,137,91,138,138,138,138,0,84,147,134,93,3
3,82,0,130,0,118,93,82,137,0,0,84,133,133,91,0,134,137,147,134,93,3,3,3,82,137,0,57,175,133,133,133,84,84,147,133,57,134,93,82,7,0,0,0,0,0,0,93,82,0,130,0,0,93,99,100,100,108,3,65,65,65,65,65,65,65,65,65,3,82,0,0,0,0,7,0,0,0,7,0,7,0,93,3,65,65,65,65,65,65,65,65,65,65,3,3
3,82,0,147,0,0,93,3,65,65,65,65,78,65,65,65,65,65,65,65,3,3,3,3,3,65,65,65,78,65,65,65,78,65,65,65,65,65,3,82,7,0,128,0,0,0,118,93,82,0,130,0,0,99,100,100,100,100,100,100,100,100,100,100,100,100,100,100,100,108,0,0,0,0,0,84,0,0,7,0,0,0,99,100,100,100,100,100,100,100,100,100,100,100,3,3
3,82,0,112,0,0,99,100,100,100,100,100,100,100,100,100,100,100,100,100,100,100,100,100,100,100,100,100,100,100,100,100,100,100,100,100,100,100,100,108,0,0,130,0,0,0,118,93,82,0,130,0,0,7,0,7,7,0,0,7,0,7,7,120,120,120,7,0,7,120,0,0,0,0,77,65,65,66,0,0,0,0,0,57,0,7,0,7,120,120,120,7,7,0,93,3
3,82,0,0,0,152,153,153,151,120,54,7,196,7,0,120,120,0,7,152,153,153,151,7,57,152,153,153,151,120,0,0,152,153,153,153,151,0,7,0,0,0,130,0,0,0,0,93,82,0,130,0,0,7,0,0,0,0,0,7,0,7,0,0,0,0,0,0,7,0,0,0,0,0,93,3,3,82,121,0,0,0,0,57,0,7,0,7,0,0,0,0,7,0,93,3
3,82,0,0,0,0,183,0,0,0,0,7,0,0,0,0,0,0,7,0,0,183,0,0,57,183,0,0,0,0,0,0,0,0,0,0,0,0,7,0,183,0,130,0,0,184,0,93,82,0,130,183,0,7,0,0,0,0,183,0,0,7,0,0,0,0,0,0,7,0,0,183,0,0,93,3,3,82,0,0,0,0,0,0,0,0,183,7,0,184,0,183,7,0,93,3
3,82,137,0,174,138,138,138,0,0,138,7,134,146,0,84,142,0,138,138,138,138,0,0,138,0,0,138,138,138,84,175,0,91,0,144,138,143,7,138,84,133,147,134,137,133,134,93,82,137,147,138,174,91,138,141,138,138,84,0,138,91,91,138,138,138,57,138,7,134,137,84,84,134,93,3,3,82,137,0,134,137,173,138,138,138,138,138,138,84,57,138,0,134,93,3
3,3,65,65,65,78,65,65,65,65,65,78,78,65,65,65,65,65,65,65,65,65,78,78,78,78,78,65,65,65,65,65,65,78,65,65,65,65,65,65,65,65,65,78,65,65,65,3,3,65,65,65,65,65,65,65,65,65,65,65,65,65,65,65,65,65,65,65,65,65,65,65,65,65,3,3,3,3,65,65,65,65,65,65,65,65,65,65,65,65,65,65,78,78,3,3
3,3,3,3,3,3,3,3,3,3,3,3,3,3,3,3,3,3,3,3,3,3,3,3,3,3,3,3,3,3,3,3,3,3,3,3,3,3,3,3,3,3,3,3,3,3,3,3,3,3,3,3,3,3,3,3,3,3,3,3,3,3,3,3,3,3,3,3,3,3,3,3,3,3,3,3,3,3,3,3,3,3,3,3,3,3,3,3,3,3,3,3,3,3,3,3
